ImageID	ClassID
qxhzidlwty	castell_cartoixa
rwiadrxaho	castell_cartoixa
qcfmdqiomk	castell_cartoixa
gxajdleuce	castell_cartoixa
zpkmfwmvjl	castell_cartoixa
lpyoapvino	castell_cartoixa
hyauofjmqm	castell_cartoixa
mmqyhnkksu	castell_cartoixa
kiidirgsoe	castell_cartoixa
cyroctcrug	castell_cartoixa
jcohlyacto	castell_cartoixa
ytdrbtkzck	castell_cartoixa
pnhwmdqalp	castell_cartoixa
lklyafuynp	castell_cartoixa
aujmbynvje	castell_cartoixa
qqmtkewxrt	castell_cartoixa
lvsxvczygl	castell_cartoixa
wvfhhcnhnw	castell_cartoixa
pelcerrqzj	castell_cartoixa
uiskihnzxz	castell_cartoixa
optshplcug	castell_cartoixa
acelgpvmcb	castell_cartoixa
fzdpgxdbcg	castell_cartoixa
oymhrsdzyd	castell_cartoixa
zbodmedavf	castell_cartoixa
jnavdmhpzi	castell_cartoixa
dkebobmnzi	castell_cartoixa
gmosdhfkkj	castell_cartoixa
wzekrftzls	castell_cartoixa
hcpciahwpu	castell_cartoixa
rfsxefhwgy	castell_cartoixa
ggfcnfwvwf	castell_cartoixa
aggunlfpay	castell_cartoixa
zrmwfnedsr	castell_cartoixa
bskapdmioe	castell_cartoixa
ymwwusykwj	castell_cartoixa
ncbwtrgwme	castell_cartoixa
znzgvxpxvm	castell_cartoixa
ltlgornaog	castell_cartoixa
abhhftuwpn	castell_cartoixa
hoizhnecwl	castell_cartoixa
uqsiuzbzit	castell_cartoixa
hovnwwrkev	castell_cartoixa
zalwmgpduw	castell_cartoixa
dcuateesid	castell_cartoixa
eqeztnsyyk	castell_cartoixa
xtstqmvigs	castell_cartoixa
jfuyhzsveh	castell_cartoixa
ghjggjgkws	castell_cartoixa
lyihwwkuge	castell_cartoixa
ikwslucsor	castell_cartoixa
rtlmdoelsp	castell_cartoixa
zevlzjeays	castell_cartoixa
ccjxcimtim	castell_cartoixa
tnzlajslmb	castell_cartoixa
ixsyirdseh	castell_cartoixa
sqmolbkkpt	castell_cartoixa
nvfdcjtiiu	castell_cartoixa
pbuzphevhp	castell_cartoixa
fdtakdbhkt	castell_cartoixa
eolbjtiiim	castell_cartoixa
kweaanjnzf	castell_cartoixa
clsauapxqm	castell_cartoixa
apduaikndm	castell_cartoixa
cgnlduvohg	castell_cartoixa
xubdrbrnyu	castell_cartoixa
xhcsqgeojw	castell_cartoixa
kuqeqfxjul	castell_cartoixa
tctijtjnvz	castell_cartoixa
tuqqrlnhrr	castell_cartoixa
rikkspkkbc	castell_cartoixa
lxkioiqgis	castell_cartoixa
vytoqirejd	castell_cartoixa
dupsxpmyzc	castell_cartoixa
apanefndfs	castell_cartoixa
faclfdynri	desconegut
xckvthfwqv	desconegut
szyavgivdj	desconegut
zmbbizegdz	desconegut
zihahphyls	desconegut
lfcnkrptem	desconegut
bhyvouqelf	desconegut
cymwjtrjip	desconegut
mhbnmhrzra	desconegut
rtcchjwmae	desconegut
idcyciywlx	desconegut
evppzxmwew	desconegut
prewpfyths	desconegut
yyyrralxws	desconegut
mddfqxbqtn	desconegut
lavdnfsaxp	desconegut
uuvgmnbadg	desconegut
ciedunwahs	desconegut
pounqntuel	desconegut
ygshaakswc	desconegut
aohqnohllo	desconegut
vqwhqigybm	desconegut
innpiopgmc	desconegut
liplszfxjv	desconegut
qlidbyxqlw	desconegut
qshhwnljrf	desconegut
yujgrqyxwd	desconegut
iklbvliatm	desconegut
kioiconrcf	desconegut
nnswlqrqam	desconegut
plscuhedvz	desconegut
iisnmkndmp	desconegut
ufplxoooby	desconegut
jpyzjandge	desconegut
xxglgeknai	desconegut
yjqvnljuot	desconegut
bjaltdomcu	desconegut
axrwmqofey	desconegut
tccsjrpizk	desconegut
yydlhpysfk	desconegut
ftrkmpsftp	desconegut
iyjwomlron	desconegut
vypiuworti	desconegut
kbevghlcvw	desconegut
btydnedmha	desconegut
uioeytlmka	desconegut
jdosuzywrt	desconegut
xldsdsnzty	desconegut
jobzjonsov	desconegut
cmcanomtbt	desconegut
obionzqfud	desconegut
mkcserapov	desconegut
zgwmakgddq	desconegut
slqneyqsjh	desconegut
nrezoozurl	desconegut
aywjaiumuy	desconegut
djqeenxvnv	desconegut
dtjjacmtjl	desconegut
ekzvhhyguk	desconegut
rfcbuzqgvq	desconegut
nprvzwbgjy	desconegut
blwcybhndr	desconegut
rnruvnrznw	desconegut
pefpghkprp	desconegut
ryfrkxbrtw	desconegut
klewvwmquj	desconegut
exqkjhfcug	desconegut
mvjbasmzxz	desconegut
vhrwuneelk	desconegut
pjtwsuwmbh	desconegut
lpdjukcbie	desconegut
hyapassmdz	desconegut
gspnffhnhp	desconegut
wgqywzmgpr	desconegut
axxcteqkrj	desconegut
ryobhorldg	desconegut
zexkdctyus	desconegut
hojbevtubi	desconegut
mejfyuphsv	desconegut
dffvxjidzg	desconegut
hrelaopxjl	desconegut
xzqrjpvohp	desconegut
xyrmizhuur	desconegut
spfblbmlmy	desconegut
tgatrpwtrr	desconegut
qupbuzoqtc	desconegut
ybnjxailaf	desconegut
kjmrmikely	desconegut
wkbyrnjtlj	desconegut
ikgdbvdmsz	desconegut
spxttiojbv	desconegut
tdofpcrgnz	desconegut
lpxwubqwhh	desconegut
mmkeuwpavd	desconegut
hieltnmgqt	desconegut
brkcdajypm	desconegut
grhilunezf	desconegut
uppzbaxpho	desconegut
bdqzuzcevq	desconegut
xwsiahxdam	desconegut
ykggukodxg	desconegut
afnpomythh	desconegut
yvyvgrssiy	desconegut
dsysfnjafl	desconegut
jupkdsryeo	desconegut
owhuhzcfmk	desconegut
mdrsudpput	desconegut
ozlwbxhhzh	desconegut
siuzeyxoib	desconegut
bdpsbfzjom	desconegut
yderggnuob	desconegut
dvvkefiugw	desconegut
bqblmwablf	desconegut
oyarvfxbmf	desconegut
vlnfkadwdp	desconegut
sxcakjqgrj	desconegut
cugakpnhyt	desconegut
desconegut_440	desconegut
vtrxpqctxd	desconegut
mshhhmouvk	desconegut
ccntnlamqh	desconegut
umbiwcwgjf	desconegut
jcogvsgjgx	desconegut
dcnxxffewk	desconegut
cibxjjbpuu	desconegut
oezmaddbxh	desconegut
ujpkttzuie	desconegut
lbedjuxydu	desconegut
goixpfaxcx	desconegut
oextmaikvv	desconegut
sjsaftbcsu	desconegut
evooineyik	desconegut
yuzjvrhqst	desconegut
fkhillxvlu	desconegut
wgjmexcvmo	desconegut
vsekldqlpk	desconegut
dmbhtkcqfg	desconegut
jhrkvnytws	desconegut
nvbjodqblw	desconegut
nxbiehbgyo	desconegut
dndlvfaqee	desconegut
zevxjulntg	desconegut
fkmelsgrxa	desconegut
ocqfrkrrge	desconegut
devtbhsnet	desconegut
fdqisodevw	desconegut
cjnbkdaluv	desconegut
bkflbagjoe	desconegut
cdxflncsjz	desconegut
yzagvkedns	desconegut
ovrmqaehyb	desconegut
mbnblbxzlt	desconegut
inegmcgfuj	desconegut
qtnhznomoc	desconegut
bijevhegkb	desconegut
ztqwknzffe	desconegut
qlkxebwhmw	desconegut
thuwmpiyso	desconegut
ihosjkgsdu	desconegut
taltxxwkco	desconegut
vdibkjtqsv	desconegut
wytaxtoyay	desconegut
klbfbeibsw	desconegut
cntwizmizs	desconegut
qiepcsitwh	desconegut
syuhvnexbs	desconegut
ifrukwqsll	desconegut
feudpudnwv	desconegut
tnfhiazasb	desconegut
gopzdnppdg	desconegut
bzfhtzuxct	desconegut
ubvfinvytq	desconegut
hdduxxlyhv	desconegut
mecxdxwuiq	desconegut
izwrwolqlh	desconegut
zylewafige	desconegut
qdfrsqwoxa	desconegut
hyyfsunngi	desconegut
amisnubczi	desconegut
bciacqvjcj	desconegut
jnjyczvdbh	desconegut
irhtabkvfn	desconegut
circsyfyet	desconegut
eovcquabqn	desconegut
gblmxaougl	desconegut
gnzkcuzasw	desconegut
rvajxwwqob	desconegut
yukfrdiwdj	desconegut
ixsergrdra	desconegut
sgcdddmyff	desconegut
awvlpwiueq	desconegut
xaoghofjdj	desconegut
tbugwczxty	desconegut
bifmvytmti	desconegut
failybzans	desconegut
mljwldhnub	desconegut
llxhbvvgul	desconegut
ssansseber	desconegut
skqemdsuaj	desconegut
ufjaujqzid	desconegut
cxttqsynlt	desconegut
ymgfkatosf	desconegut
bxyqmuhcll	desconegut
tykehcvbqa	desconegut
pybcpxbtcd	desconegut
kqhyhmldab	desconegut
fmxagdoyhr	desconegut
mfkkydczai	desconegut
bjwslqwiua	desconegut
mmqyxcuqvb	desconegut
jdolqtrfmo	desconegut
zrpxiclbos	desconegut
rzzxhuurpw	desconegut
klsoprqqba	desconegut
tjptonmnjb	desconegut
tjkxehftcn	desconegut
bncgtncxel	desconegut
zzssvmfstq	desconegut
yjaiyuakor	desconegut
pcdclqawwk	desconegut
zahzecxdwh	desconegut
eurtvsdptg	desconegut
pwssaagljt	desconegut
ycrxzqfaov	desconegut
qhnbzekggp	desconegut
kvxbksgknb	desconegut
tfwxbqienx	desconegut
bfxsmxdxoq	desconegut
mjxamudlzj	desconegut
zzitakmikw	desconegut
glkumpwkls	desconegut
cbwqgqqsxu	desconegut
zoodpqtbwj	desconegut
vjjdcdapkq	desconegut
yovmvapcts	desconegut
kwhqhuqmbo	desconegut
mhdbtukynw	desconegut
mjuozxfinz	desconegut
oexpxbrspm	desconegut
duqjjbbsmc	desconegut
nsyooearqv	desconegut
sxjnwednfl	desconegut
vbcetwathx	desconegut
pxlxqzwbnn	desconegut
kphqevhwcq	desconegut
xoctoiivel	desconegut
ksmokrwulx	desconegut
xhdseglyng	desconegut
ohrtwvvuix	desconegut
ryrveqirde	desconegut
ybsmfkrrdb	desconegut
fyevnidylh	desconegut
aituwhpgsp	desconegut
lbtlcjhivj	desconegut
diuhxnfqda	desconegut
rrznsuebjo	desconegut
uehapmzasn	desconegut
rhmulxnnkg	desconegut
ximinqwitv	desconegut
hlminuuvbr	desconegut
zetmqjtzji	desconegut
jvqwvdgege	desconegut
mchpogfzgm	desconegut
qnsmlgoxkm	desconegut
wdgelrodow	desconegut
htdnwlgjtg	desconegut
tfuxwvoiuw	desconegut
ecwktasdwt	desconegut
rluquannsn	desconegut
vwdlnzypyv	desconegut
jgobnhlsik	desconegut
trbvafmgfk	desconegut
bomunybmqf	desconegut
qnhmklihcs	desconegut
qiaqmgxijs	desconegut
vnpbfmnoei	desconegut
pjmrjnmhhz	desconegut
uukbgfadhr	desconegut
rlgbkhftts	desconegut
qaagngwlsv	desconegut
qenysqhbzp	desconegut
hhkndfldla	desconegut
xxfogkudmo	desconegut
hzhkdnkiok	desconegut
ozovmyeawv	desconegut
rgqgpfpndq	desconegut
lmjerapxzg	desconegut
syovaxcygd	desconegut
exrqwbeoja	desconegut
kmnkjxbfpv	desconegut
wbtbuzxeyb	desconegut
mzpvnjofzf	desconegut
mqeshwhuvm	desconegut
miqpcmazxe	desconegut
rdzsccxvmz	desconegut
osmclpqihf	mnactec
onpktnrpna	mnactec
fcgqnivrce	mnactec
parsmtvfgw	mnactec
ijjxkyocts	mnactec
ibqdoqhtby	mnactec
gosmkdjutr	mnactec
whcbdkhkrg	mnactec
tlhnsuaggx	mnactec
prlqkqxsal	mnactec
wbgvxogliu	mnactec
tqoqiamqgi	mnactec
elgcskguds	mnactec
urhwtfwlds	mnactec
quhgsnkgxd	mnactec
vxlbmebzjn	mnactec
wdnpxeudmr	mnactec
yumjvsciru	mnactec
kufsunbmdl	mnactec
fbunjrzkbr	mnactec
xcwaqzqlqh	mnactec
fnjkhoklgf	mnactec
uemghhbwog	mnactec
ghqdtdrlxj	mnactec
ndvyaxlybh	mnactec
ompmlmucya	mnactec
jpkehxzvsw	mnactec
ofqpiusfqg	mnactec
jmnrnjyxjn	mnactec
ktqmdwyodl	mnactec
apflzvnveo	mnactec
fkbydxgpke	mnactec
xdlpaxhbsy	mnactec
wkisyeuhvn	mnactec
eowzhilcnd	mnactec
zepwsmifjx	mnactec
qeofsodzqt	mnactec
uxuedjdbio	mnactec
qpsrgavkmw	mnactec
qtjhdheidt	mnactec
jpkschvpfb	mnactec
mdttnbvwuu	mnactec
xtmijzoalu	mnactec
nzkbzogsii	mnactec
mppbypsvzh	mnactec
wimwvwgwut	mnactec
vjrmjfpfjj	mnactec
usmfvvqruh	mnactec
jhqlsaeuwi	mnactec
maxgpovktk	mnactec
ystkhkldgp	mnactec
jgfvjuwblf	mnactec
jyzcabwujd	mnactec
lvgqblwcrw	mnactec
wwssjcbsnf	mnactec
wcojwrbrkq	mnactec
wsmgepfkls	mnactec
sxndgwcyqa	mnactec
stjsvsvwbp	mnactec
qiausglzdi	mnactec
wulybhrarg	mnactec
vdyqkyulps	mnactec
uitmsrnouo	mnactec
ddxtnidlen	mnactec
wwooqgbrjt	mnactec
ilphingcop	mnactec
gccikcojfh	mnactec
wenwsbohrv	mnactec
uwlsfjyxxh	mnactec
yggupsudgk	mnactec
kjzubhqhec	mnactec
kcxcnlusww	mnactec
dhwbvmpsnr	mnactec
xrhoxdxngi	mnactec
eyntbffhua	mnactec
dksdeujwkx	dona_treballadora
zgtzwdypkj	dona_treballadora
xfmezsaxjy	dona_treballadora
lltacrbfvc	dona_treballadora
cxkndhvhlp	dona_treballadora
ijasfrornv	dona_treballadora
ikmtahaxsd	dona_treballadora
uudiheysyo	dona_treballadora
smxccyxmtn	dona_treballadora
jqcfwanisq	dona_treballadora
iujroyeftb	dona_treballadora
nxseyhqfom	dona_treballadora
erbxklffjm	dona_treballadora
ukyrpcjzuc	dona_treballadora
wavqqbsuaa	dona_treballadora
mruptfhdom	dona_treballadora
omncmumlzb	dona_treballadora
iihlbeiidg	dona_treballadora
fnocqvsxqa	dona_treballadora
nzvfctfqvi	dona_treballadora
mcsgxcrfim	dona_treballadora
unnmzkabmn	dona_treballadora
mqpkoeeylq	dona_treballadora
kpptaiipvz	dona_treballadora
dgwccztikt	dona_treballadora
xriljyrert	dona_treballadora
cxxmfbonyk	dona_treballadora
qkoqzbpocl	dona_treballadora
ilfzhqbsnu	dona_treballadora
zqyqwlqscy	dona_treballadora
tyokpuztch	dona_treballadora
atswxfecog	dona_treballadora
hbelimfclr	dona_treballadora
ekgbaboydc	dona_treballadora
indaoktkjq	dona_treballadora
qnmkpwduhc	dona_treballadora
jqrhtocrdh	dona_treballadora
lvwhhthxmr	dona_treballadora
clnymqhkaa	dona_treballadora
grqooygdjj	dona_treballadora
bxlgkwqtkl	dona_treballadora
szmjdlysig	dona_treballadora
lurpashfse	dona_treballadora
bsbzwczpkz	dona_treballadora
qvojxanqzy	dona_treballadora
pdwsngeuow	dona_treballadora
lpqdglipub	dona_treballadora
kpekufwnoj	dona_treballadora
brwoxtdhzl	dona_treballadora
hlwosowgwf	dona_treballadora
zndyimuodk	dona_treballadora
bykkavzcio	dona_treballadora
ruxzdustfi	dona_treballadora
gkarayzwnb	dona_treballadora
aovbdikeyq	dona_treballadora
cjlspminyc	dona_treballadora
fyviiaayeo	dona_treballadora
oalkqwzxad	dona_treballadora
zensdqmfht	dona_treballadora
mwpkwaxuxg	dona_treballadora
xvyuxnhjab	dona_treballadora
qsryaelnnh	dona_treballadora
ugrjrisbvh	dona_treballadora
phkejxgcdh	dona_treballadora
etlzfspcoe	dona_treballadora
tojuvkvyvk	dona_treballadora
ndvcsgspvy	dona_treballadora
yecjhhgwcm	dona_treballadora
deummmeklg	dona_treballadora
xgxvyyrdua	dona_treballadora
edniyhehnc	dona_treballadora
opdfwgvtjs	dona_treballadora
zfnjlyelgg	dona_treballadora
kmidrmomkc	dona_treballadora
ndsstaufqj	teatre_principal
dhageifufd	teatre_principal
vjtmqrjgqf	teatre_principal
gzujuybyeo	teatre_principal
agbuprmjas	teatre_principal
vleifboeuq	teatre_principal
nqgyguqafu	teatre_principal
dgvjiclowc	teatre_principal
ayfmwhkafq	teatre_principal
sdffcxckvb	teatre_principal
ttkeorjcem	teatre_principal
fyerjtncyt	teatre_principal
qwxcbyhuoq	teatre_principal
ccsrwjnrsa	teatre_principal
iinquylntb	teatre_principal
gcgehfvmmc	teatre_principal
gqhtnxdues	teatre_principal
feqmexwhit	teatre_principal
pqnfacdiaf	teatre_principal
utrxyzlknr	teatre_principal
oftxpxfyjr	teatre_principal
ccjglzpqrq	teatre_principal
zpmmkdvxdx	teatre_principal
rtqezsijto	teatre_principal
niclywruhw	teatre_principal
twolgzmmkf	teatre_principal
fqypjlhnrv	teatre_principal
hnhvxwwcug	teatre_principal
ymyqgxdrqq	teatre_principal
iwjlpedfvf	teatre_principal
qlqtgxbgaf	teatre_principal
qxmtzywtux	teatre_principal
wufvbrxpnx	teatre_principal
dmvglrwkzt	teatre_principal
ubxhksngth	teatre_principal
nadphxtyxl	teatre_principal
vyyrecqjrf	teatre_principal
fuiubdmhii	teatre_principal
ojtalqqugk	teatre_principal
fbeusfmwcz	teatre_principal
owgbnwmcpq	teatre_principal
jxxrdlxmln	teatre_principal
rdzkihfvxx	teatre_principal
miozdpcyjj	teatre_principal
vnicpnassk	teatre_principal
xayjevntoc	teatre_principal
tfmzerkqpb	teatre_principal
pvqkypkgys	teatre_principal
zhlvfhbnso	teatre_principal
ajynbhistq	teatre_principal
zqgzzccyjw	teatre_principal
dtfesdvtab	teatre_principal
wqdksrxdlp	teatre_principal
cvmawbrczs	teatre_principal
fyzghgqxxn	teatre_principal
wlfxewijfm	teatre_principal
ljxfosehze	teatre_principal
dlfdauouyn	teatre_principal
vwbmnbhjpm	teatre_principal
lqcyucihej	teatre_principal
alhbsxqieb	teatre_principal
egpatgklto	teatre_principal
qopjffdmsp	teatre_principal
utfomzrask	teatre_principal
unywjpjjmz	teatre_principal
hsgkbwzxcp	teatre_principal
alaeayyxfl	teatre_principal
ozmlymmoft	teatre_principal
hcenbrlquw	teatre_principal
gbxkpatcox	teatre_principal
rherstgkpt	teatre_principal
dsxlurvnnn	teatre_principal
iquxfglelj	teatre_principal
bhsnrjtabf	teatre_principal
omgiwnworc	teatre_principal
ckgxudddnm	farmacia_albinyana
gpcfjfrccu	farmacia_albinyana
bvntulagem	farmacia_albinyana
xcvascruvw	farmacia_albinyana
rjdnvemqtk	farmacia_albinyana
athzwscsnx	farmacia_albinyana
jkgypkihvf	farmacia_albinyana
aytpuddtag	farmacia_albinyana
fauwudpids	farmacia_albinyana
pfagpkocdc	farmacia_albinyana
ugtaxxrzni	farmacia_albinyana
lkdxmpkcce	farmacia_albinyana
vmntnwocdl	farmacia_albinyana
kplnvgrapn	farmacia_albinyana
uieoncwujk	farmacia_albinyana
btfzjoqyyf	farmacia_albinyana
gadagvkgiz	farmacia_albinyana
wvnvkckiqg	farmacia_albinyana
vxmgoygdid	farmacia_albinyana
jfusvyppff	farmacia_albinyana
rzcqprrrzc	farmacia_albinyana
bponbqjcmo	farmacia_albinyana
xvufavwlrk	farmacia_albinyana
adbbwzixru	farmacia_albinyana
xbavhcogxq	farmacia_albinyana
oakblunela	farmacia_albinyana
ithqxhyiqr	farmacia_albinyana
fhwerwbaxw	farmacia_albinyana
otewiutbfn	farmacia_albinyana
cqwsukhvtm	farmacia_albinyana
fqfcmvcejt	farmacia_albinyana
ekqfllyauv	farmacia_albinyana
uiiuenxmgh	farmacia_albinyana
mnvkcuhjkv	farmacia_albinyana
pbiucjrgsc	farmacia_albinyana
vkcxhhbvzm	farmacia_albinyana
ygowwluyyk	farmacia_albinyana
bpqouaaxov	farmacia_albinyana
tjuhldqdti	farmacia_albinyana
oigmszkyxm	farmacia_albinyana
lvrzdysoex	farmacia_albinyana
tlkcthprhk	farmacia_albinyana
ydrxaawtty	farmacia_albinyana
qnpyjleeug	farmacia_albinyana
ycuixeyndi	farmacia_albinyana
wznhafkopi	farmacia_albinyana
qwjugtthva	farmacia_albinyana
fzcmytkafr	farmacia_albinyana
gptltdiect	farmacia_albinyana
uffeltfpsr	farmacia_albinyana
upedvuxvll	farmacia_albinyana
gdvqumaouv	farmacia_albinyana
qvzwtcqccr	farmacia_albinyana
nemigcpzdw	farmacia_albinyana
mkvthscsrk	farmacia_albinyana
atligrwdxf	farmacia_albinyana
wkheyqcdpd	farmacia_albinyana
ujvvhkxubf	farmacia_albinyana
lpyagdjllb	farmacia_albinyana
bcynwmjtii	farmacia_albinyana
nhjfsafccp	farmacia_albinyana
kkkatpmcrm	farmacia_albinyana
rbbloldcrm	farmacia_albinyana
ixspwwrgea	farmacia_albinyana
axbnlpgwmv	farmacia_albinyana
qrlmqpiacw	farmacia_albinyana
dlogjyrach	farmacia_albinyana
zhrjqrmbrb	farmacia_albinyana
ebaqbehenz	farmacia_albinyana
bmiuszzcaz	farmacia_albinyana
pbdrqyxvog	farmacia_albinyana
xjltyvymmv	farmacia_albinyana
wwrqlclawb	farmacia_albinyana
dizdqaffbf	farmacia_albinyana
ymqojegnec	farmacia_albinyana
erfvnyximb	escola_enginyeria
szbzkkwnbk	escola_enginyeria
gfsifpaozo	escola_enginyeria
qublytjdcu	escola_enginyeria
rddaqvmcqf	escola_enginyeria
rmskarglqc	escola_enginyeria
rwskzylvrj	escola_enginyeria
ktxwyewkjo	escola_enginyeria
jmtsskycge	escola_enginyeria
uxktlchfvs	escola_enginyeria
hudnwwzqfy	escola_enginyeria
lishxlixxb	escola_enginyeria
uvjmtcawxu	escola_enginyeria
yvclycpsvl	escola_enginyeria
ofzcksvyim	escola_enginyeria
dqggnapgdq	escola_enginyeria
vixcpahmvh	escola_enginyeria
vgfdxwdeca	escola_enginyeria
bntbjctroh	escola_enginyeria
exehxluptj	escola_enginyeria
gyfikaiwyx	escola_enginyeria
xhymyeulyl	escola_enginyeria
jumllliywg	escola_enginyeria
fqmxxjexof	escola_enginyeria
ospnpxyqbn	escola_enginyeria
ffgjvxrglq	escola_enginyeria
myleusgppy	escola_enginyeria
txthzyazak	escola_enginyeria
hnhofgriyj	escola_enginyeria
ddqhgubyws	escola_enginyeria
kvxynkziwu	escola_enginyeria
qqszvqrngw	escola_enginyeria
dfoivarsim	escola_enginyeria
awqfhrxudu	escola_enginyeria
rqoexofmyy	escola_enginyeria
efuqyztzqg	escola_enginyeria
eopiffvraq	escola_enginyeria
adfqkssrku	escola_enginyeria
mhbseskouk	escola_enginyeria
elognipybe	escola_enginyeria
lqcpsysbiu	escola_enginyeria
stkhqtjmmy	escola_enginyeria
scyguxtgwq	escola_enginyeria
hycavwllyd	escola_enginyeria
dfyskzrpad	escola_enginyeria
ibeiofzjhi	escola_enginyeria
twrflzkbji	escola_enginyeria
ftpvgceoof	escola_enginyeria
znizfcfveg	escola_enginyeria
bwjrbhtypz	escola_enginyeria
ydbpnwbalc	escola_enginyeria
iszqdmwhfj	escola_enginyeria
imtltdoybg	escola_enginyeria
ongijismin	escola_enginyeria
vvgvlihfnf	escola_enginyeria
ysawbhwffm	escola_enginyeria
ijihzxbfkd	escola_enginyeria
etotkrguce	escola_enginyeria
zdqptfqjln	escola_enginyeria
yuyzyerdli	escola_enginyeria
bttvdinylw	escola_enginyeria
pxvrpyvcxi	escola_enginyeria
vcjhdqxblf	escola_enginyeria
vpaerisaap	escola_enginyeria
bysbrospfg	escola_enginyeria
ulfrfaqxno	escola_enginyeria
vaucxyvlgo	escola_enginyeria
egseyiztzg	escola_enginyeria
quulfguhyg	escola_enginyeria
mhegchzacy	escola_enginyeria
veghnuczua	escola_enginyeria
bgsesoxufv	escola_enginyeria
crqtcjsrca	escola_enginyeria
qrswecgohd	escola_enginyeria
aimuuthxqs	escola_enginyeria
bmdkfdmtvk	societat_general
ftqitgsbkc	societat_general
mbfyojtxnm	societat_general
unuzfeabnj	societat_general
osgphhotmi	societat_general
psrdhkykyx	societat_general
ppulrwzjfm	societat_general
yperitfxzy	societat_general
geaifamrlk	societat_general
cspfzoybhk	societat_general
ykefpckvbq	societat_general
cxggajjcwd	societat_general
rzaaclxqpj	societat_general
stuopfxhci	societat_general
svejjdollu	societat_general
tdkhsxyxvf	societat_general
bhsovcxjiq	societat_general
lwgvmzfpeb	societat_general
bbxerxgbdj	societat_general
cwodnksefi	societat_general
otfvlsuoon	societat_general
bzxpnjxyud	societat_general
ktkahcjkse	societat_general
dspxryjrvm	societat_general
ozhwtktuab	societat_general
refnbhfuvu	societat_general
cbkhzimtoe	societat_general
xvcvwfjsag	societat_general
njxlrwatys	societat_general
tfxbflujhw	societat_general
kirhuajvbw	societat_general
wickfsqwxk	societat_general
ztxrcmowjy	societat_general
qyztthrnbe	societat_general
ipdvegrphr	societat_general
mdzhcsuenf	societat_general
afkpayxvzq	societat_general
ptwjeorzhg	societat_general
kfkwsjxvps	societat_general
mnvfoluwpj	societat_general
nlptvkihiu	societat_general
egxdnfxane	societat_general
wptgipnfgp	societat_general
dkwqbitjik	societat_general
vqxyoxnujj	societat_general
rmczthbysn	societat_general
szhqoxdsrb	societat_general
sycwjcclbz	societat_general
brhqfcdbhi	societat_general
gcjmnczvty	societat_general
wljzchjnqg	societat_general
yxhlwbillj	societat_general
tymcjiguca	societat_general
bnpvikcuxg	societat_general
zemecjjnhj	societat_general
hmxrtbjxyk	societat_general
lkwkdjdqlu	societat_general
plwzcnghpv	societat_general
ewlslvkjeo	societat_general
bkvkmfzxlq	societat_general
qvcdokewrm	societat_general
bqypgfftes	societat_general
iluocltbtk	societat_general
ynikspegeq	societat_general
hhdxerksts	societat_general
rbnikwrexd	societat_general
viwdakqafn	societat_general
eldzyesrqv	societat_general
ikzpqxugnw	societat_general
vwdquxsgzh	societat_general
cizcmwwotm	societat_general
lraxebnysx	societat_general
qkrzxkslwp	societat_general
cxletgxdee	societat_general
acfvtmktll	societat_general
yjmfhadlax	masia_freixa
zajwhkxbcj	masia_freixa
dlteqzcuax	masia_freixa
pkwrnjhvqx	masia_freixa
nvtibynjrs	masia_freixa
caycvlbvlk	masia_freixa
oxswbohvrw	masia_freixa
dxgeuyxhtn	masia_freixa
nbtbgxdldn	masia_freixa
sigzbxdojz	masia_freixa
kyqzdqwutd	masia_freixa
omphmjsaor	masia_freixa
pwsjltwmsi	masia_freixa
cahrnwxhlz	masia_freixa
ckyilkvbro	masia_freixa
rcaiqsjhmt	masia_freixa
nkbqrxoxal	masia_freixa
nzdvbkvfks	masia_freixa
xkwewjhbbs	masia_freixa
cvpvluwgqh	masia_freixa
arkyfgpfxy	masia_freixa
xrwcvkwmmo	masia_freixa
ncqgcbqajm	masia_freixa
vxeyzrzruh	masia_freixa
ybqbtiaiip	masia_freixa
crmdvinpjt	masia_freixa
qsdjpaqelb	masia_freixa
pmsralwafn	masia_freixa
pbureqhalh	masia_freixa
jcpnlbvlmy	masia_freixa
wlnuvfutge	masia_freixa
fnhwkamqry	masia_freixa
lsyzwzyoxv	masia_freixa
qymzdbxzrh	masia_freixa
oijmpcchha	masia_freixa
vqnarwtlzl	masia_freixa
qvplpnrcne	masia_freixa
yttqysuief	masia_freixa
dyidqyhfra	masia_freixa
ornlneqdix	masia_freixa
rffukgwsst	masia_freixa
fmfopvgjsl	masia_freixa
sxmeiddfrd	masia_freixa
raccenqiuh	masia_freixa
adwwqlupfz	masia_freixa
niqommwlua	masia_freixa
cnxipapnpe	masia_freixa
hfqqnnotjl	masia_freixa
aiiklcdzpc	masia_freixa
dovaujatzv	masia_freixa
uzvuynmhvm	masia_freixa
wbsgyzlesn	masia_freixa
bbtbcpacdz	masia_freixa
uskkxtwedg	masia_freixa
palenpopbo	masia_freixa
ijcsflited	masia_freixa
qvtwcagtto	masia_freixa
uldnozqahl	masia_freixa
bjreboshhq	masia_freixa
fnsbqtxdjs	masia_freixa
laprfczfog	masia_freixa
ltfwrhzfmf	masia_freixa
oqsocutdcm	masia_freixa
mzhhhmepvy	masia_freixa
kefbskfwhc	masia_freixa
agsbtyiiie	masia_freixa
rprhfgkiqj	masia_freixa
weqntickxk	masia_freixa
nfkgktaenf	masia_freixa
bvmrloapal	masia_freixa
pscwhvqecn	masia_freixa
mhyqdpxwtr	masia_freixa
likilxembx	masia_freixa
hrgitvspmz	masia_freixa
oegqejrkww	masia_freixa
xffbywplin	estacio_nord
hbcviknitt	estacio_nord
mgschhuxqx	estacio_nord
mpmuznymjh	estacio_nord
pkhqmrqksp	estacio_nord
wqtagyihdq	estacio_nord
zalrypsvqt	estacio_nord
laveytxrxm	estacio_nord
ewvwhwqhec	estacio_nord
kiagmbomsl	estacio_nord
jqngvvbpaz	estacio_nord
igpewqrspm	estacio_nord
cqrwgkgfpp	estacio_nord
jddvlcvgzb	estacio_nord
utahtlodzv	estacio_nord
ifuddagigg	estacio_nord
qulyjdkbhb	estacio_nord
zojxcjmnxt	estacio_nord
decuffzeln	estacio_nord
lsxtkgbifi	estacio_nord
ivacvmsgvg	estacio_nord
nqolkgznqh	estacio_nord
gyaptyhtfi	estacio_nord
pjwbxnhfaw	estacio_nord
tdvjzjbqyt	estacio_nord
osaxixnisy	estacio_nord
dhiupsiouf	estacio_nord
nsbkwumhpb	estacio_nord
azptmdnmnq	estacio_nord
cavnrorgki	estacio_nord
ogtdwmxguq	estacio_nord
lfyrmkakfz	estacio_nord
xlpszgymlm	estacio_nord
nlxzvmezxt	estacio_nord
jdgrhlllvi	estacio_nord
iccqgkthpu	estacio_nord
wneuvwrmvj	estacio_nord
codvwryras	estacio_nord
bhoxwpsadc	estacio_nord
vkvylvlpth	estacio_nord
awkkixrgur	estacio_nord
gqphfwayhd	estacio_nord
mptkkjzvsy	estacio_nord
falrcdkpbl	estacio_nord
qldczzvslb	estacio_nord
nqknibarww	estacio_nord
wodyxcshdu	estacio_nord
sowyxexwnf	estacio_nord
poiqvbxlys	estacio_nord
ctdimplvuw	estacio_nord
panzsgmuae	estacio_nord
xpdycxodks	estacio_nord
onavtrozfx	estacio_nord
wmgffbebyf	estacio_nord
yrqraaytbd	estacio_nord
scsmxwhsbo	estacio_nord
whogdindxk	estacio_nord
cqhavsrulp	estacio_nord
omcoepqblk	estacio_nord
gblboeqdln	estacio_nord
vhwslqujeq	estacio_nord
ckxgsiepar	estacio_nord
ifymwbvibe	estacio_nord
inqtitufnb	estacio_nord
nohtlhxpdm	estacio_nord
jmkzjkrige	estacio_nord
vwkvvbgwgq	estacio_nord
xrudcfzeap	estacio_nord
pmoqwywvel	estacio_nord
izevfhfjev	estacio_nord
jvtfbwgkoq	estacio_nord
nqembcsupf	estacio_nord
yjgggxoyeu	estacio_nord
vwwqbsqjvs	estacio_nord
zykyecprsu	estacio_nord
fdqkibqkaf	catedral
imepyatwwr	catedral
xgrlthceid	catedral
zheneolyoz	catedral
skoeyikkgr	catedral
brkywgrdhl	catedral
vqbvbfknmo	catedral
rehvadxuhg	catedral
drsybtrvoi	catedral
mdtxivfilq	catedral
pkeockizmy	catedral
xtajeeldhc	catedral
mbfuqqnwkh	catedral
qaodifrtyq	catedral
mwivphfmcs	catedral
xqwevxdpcw	catedral
jqmhbtskdm	catedral
knqxenizwo	catedral
hfyqohtrpd	catedral
yttigaaqzu	catedral
ekjxkjioef	catedral
oomnzhhatd	catedral
daxyjpeihl	catedral
vkmojowlcl	catedral
xjfyjfvdyn	catedral
qnczhrlldi	catedral
zltyyygrrj	catedral
xzqvpvdysc	catedral
shbmmkutqx	catedral
djhhlnnaot	catedral
nqjqjgraqu	catedral
jtiwoaqgom	catedral
oknkjymval	catedral
snmmzgwcor	catedral
aralbyotor	catedral
fwudsfdmpm	catedral
tdisyqrbmy	catedral
pjdyatlwhc	catedral
ckchjboypr	catedral
xkorkkxccz	catedral
rqufvdbnql	catedral
ehbczhflcd	catedral
azqdgzpefj	catedral
ikvjggjxya	catedral
jxpeqxbzbu	catedral
bskrudtjwr	catedral
lefaewqzxv	catedral
ieuupdcbti	catedral
djsgogpsfm	catedral
juyiwqnybi	catedral
cxkfkmerew	catedral
plxfeaathh	catedral
vkyotzromm	catedral
oqocdkjmhd	catedral
cwzjarhatr	catedral
drbpxwhokr	catedral
qtgxkdamjd	catedral
ypzrveqfbe	catedral
phvuycinmy	catedral
yijrekoczi	catedral
gjcpcramhi	catedral
lmcyedcyxw	catedral
mcagpkhyib	catedral
viqycoctib	catedral
xwktkzpbul	catedral
gtbkhdlqiv	catedral
qgdmejpndo	catedral
udctiawwom	catedral
oxqmpdxljd	catedral
bxbnyzrznq	catedral
unsuavwuse	catedral
tanpbelkpy	catedral
ixortslbjv	catedral
uuhftzblyu	catedral
nabaqqypto	catedral
ixftefhble	mercat_independencia
nsnajeitfd	mercat_independencia
vszgglcdoa	mercat_independencia
sbkvrvdzpz	mercat_independencia
waejfniwov	mercat_independencia
bpzpuaclbh	mercat_independencia
rzpkfrkqjs	mercat_independencia
wmpizihxdn	mercat_independencia
tlvujityax	mercat_independencia
knqjxzekgr	mercat_independencia
kqpcxycddw	mercat_independencia
kbuxqhryeh	mercat_independencia
vdapjeldxx	mercat_independencia
tcijfhdspx	mercat_independencia
nqvcuziyem	mercat_independencia
uxecpiuifh	mercat_independencia
dkxjxtklrp	mercat_independencia
pbddjhsijc	mercat_independencia
mgunwmothr	mercat_independencia
hcflhtkcnf	mercat_independencia
jksgnznbgz	mercat_independencia
odwgsjltuw	mercat_independencia
imqwnmvhkr	mercat_independencia
zivgunrewg	mercat_independencia
tbrtnlfidu	mercat_independencia
dquzayhazs	mercat_independencia
zkeeunzmxo	mercat_independencia
qehvboakho	mercat_independencia
krfpsyvhgd	mercat_independencia
zwmkcepslo	mercat_independencia
bknlaexebv	mercat_independencia
ysawcsejmx	mercat_independencia
gvmjoagcxs	mercat_independencia
qzolxymtwl	mercat_independencia
vbydfsjzqb	mercat_independencia
rapbqywgur	mercat_independencia
ayzxjlpqhe	mercat_independencia
ohdrujpyls	mercat_independencia
gleobswkcz	mercat_independencia
vvjaqagxow	mercat_independencia
khjvcbvrwr	mercat_independencia
ywmwvdnhid	mercat_independencia
sgjfmyzehm	mercat_independencia
gvrdgpuyqi	mercat_independencia
ipiizhyxif	mercat_independencia
jysfxjbbwe	mercat_independencia
rnzifbpnsn	mercat_independencia
sohddccqut	mercat_independencia
vjlvqgrtut	mercat_independencia
zbqfgxtevp	mercat_independencia
ffiravhuvv	mercat_independencia
plkrfsbqtu	mercat_independencia
cakjdiizji	mercat_independencia
mzvbhrcvty	mercat_independencia
nputcziefr	mercat_independencia
xwskoqpnlp	mercat_independencia
qwqbnixeyf	mercat_independencia
hiqvrmpftp	mercat_independencia
cufqcnrmdh	mercat_independencia
nvpdlddnxz	mercat_independencia
rwwkjunbpr	mercat_independencia
efzkdkcwxm	mercat_independencia
uaujvizkpf	mercat_independencia
nifpjdnrtv	mercat_independencia
xpzjpolmvu	mercat_independencia
mqupljnvsl	mercat_independencia
tbseakrbio	mercat_independencia
ovxaxglpbm	mercat_independencia
hktatrawee	mercat_independencia
hchzwgpyzf	mercat_independencia
vjgodlwgcf	mercat_independencia
qnqsgybnhh	mercat_independencia
knntjvmlol	mercat_independencia
ivzaejkzkv	mercat_independencia
yduhmjxrim	mercat_independencia
vbuqyialhz	ajuntament
qoaiunxytf	ajuntament
phtwgyrlek	ajuntament
pdqovkrqum	ajuntament
ybnkhxmfrr	ajuntament
yghqcjiqio	ajuntament
kudsitjkva	ajuntament
rmsghyrfsj	ajuntament
ahkypueabv	ajuntament
fvthfpimmy	ajuntament
odkfirhszv	ajuntament
mvfyrdwszg	ajuntament
rqxnebppih	ajuntament
fjnuaskzhw	ajuntament
fkeiulkins	ajuntament
vsdfbcdjnj	ajuntament
nguzdenclt	ajuntament
wiefuykuzy	ajuntament
sfvxnoaqvm	ajuntament
wzeoyuaubz	ajuntament
zyxxgfgnev	ajuntament
pbawisatut	ajuntament
jqhwsyczpg	ajuntament
aurjcqjfae	ajuntament
fslwfohase	ajuntament
yyykqwvgze	ajuntament
htmfcmxvak	ajuntament
eimktmmvmf	ajuntament
oqyptthfgr	ajuntament
mftfhnkncz	ajuntament
zfdjmdqvpl	ajuntament
ctslmjngzu	ajuntament
umjxxcqgtx	ajuntament
rvgnhlnypi	ajuntament
morkcmtgbt	ajuntament
sgmurlwcwr	ajuntament
thvagkczip	ajuntament
rmqycpuehk	ajuntament
dbtdmmzptj	ajuntament
ywepxwnmkf	ajuntament
nddnudhfsj	ajuntament
apjkelmjxe	ajuntament
xybspemgqe	ajuntament
ghpjlswjax	ajuntament
tobympjzik	ajuntament
vrhzayfgme	ajuntament
czmrnzzrmj	ajuntament
tfxzuvkbeq	ajuntament
qfoyzguoqy	ajuntament
urycyajyvp	ajuntament
ywpumayaal	ajuntament
ffreelmstz	ajuntament
uiqyymdhys	ajuntament
vjeamotpbl	ajuntament
dngmjbbomo	ajuntament
uujvvhhmyc	ajuntament
bevrvakjzj	ajuntament
bbdjycgvue	ajuntament
ohpypzldyc	ajuntament
phzswniqyv	ajuntament
uukeivcvjb	ajuntament
duokjklmyt	ajuntament
aqjhqqtcpy	ajuntament
mxvvnlwahu	ajuntament
ddwequxgfb	ajuntament
mfauiutmob	ajuntament
qzbatdzibg	ajuntament
fzrfsacmgx	ajuntament
bjaayhxcua	ajuntament
aoqmoekicv	ajuntament
ikyikgljhe	ajuntament
gszcwfcsup	ajuntament
wcrnyshcpz	ajuntament
gmbzzpoapj	ajuntament
aagfohyoru	ajuntament
